..........
..........
..1.......
...11.....
...1..1...
....P.1...
.....11....
..........
